7 7 7 7 7 7 7 7 7 7 7 7 7 7 7 7 7 7 7 7 7 7 7 7 7 7 7 7 7 7 7 7 7 7 7 7 7 7 7 7 7 7 7 7 7 7 7 7 7 7 
7 7 7 7 7 7 7 7 7 7 7 7 7 7 7 7 7 7 7 7 7 7 7 7 7 7 7 7 7 7 7 7 7 7 7 7 7 7 7 7 7 7 7 7 7 7 7 7 7 7 
7 7 7 7 7 7 7 7 7 7 7 7 7 7 7 7 7 7 7 7 7 7 7 7 7 7 7 7 7 7 7 7 7 7 7 7 7 7 7 7 7 7 7 7 7 7 7 7 7 7 
7 7 7 7 7 7 7 7 7 7 7 7 7 7 7 7 7 7 7 7 7 7 7 7 7 7 7 7 7 7 7 7 7 7 7 7 7 7 7 7 7 7 7 7 7 7 7 7 7 7 
7 7 7 7 7 7 7 7 7 7 7 7 7 7 7 7 7 7 7 7 7 7 7 7 7 7 7 7 7 7 7 7 7 7 7 7 7 7 7 7 7 7 7 7 7 7 7 7 7 7 
7 7 7 7 7 7 7 7 7 7 7 7 7 7 7 7 7 7 7 7 7 7 7 7 7 7 7 7 7 7 7 7 7 7 7 7 7 7 7 7 7 7 7 7 7 7 7 7 7 7 
7 7 7 7 7 7 7 7 7 7 7 7 7 7 7 7 7 7 7 7 7 7 7 7 7 7 7 7 7 7 7 7 7 7 7 7 7 7 7 7 7 7 7 7 7 7 7 7 7 7 
7 7 7 7 7 7 7 7 7 7 7 7 7 7 7 7 7 7 7 7 7 7 7 7 7 7 7 7 7 7 7 7 7 7 7 7 7 7 7 7 7 7 7 7 7 7 7 7 7 7 
7 7 7 7 7 7 7 7 381 382 382 382 382 382 382 382 382 382 382 382 382 382 382 382 382 382 382 382 382 382 382 382 382 382 382 382 382 382 382 382 382 383 7 7 7 7 7 7 7 7 
7 7 7 7 7 7 7 7 423 424 424 424 424 424 424 424 424 424 424 424 424 424 424 424 424 424 424 424 424 424 424 424 424 424 424 424 424 424 424 424 424 425 7 7 7 7 7 7 7 7 
7 7 7 7 7 7 7 7 423 424 424 424 424 424 424 424 424 424 424 424 424 424 424 424 424 424 424 424 424 424 424 424 424 424 424 424 424 424 424 424 424 425 7 7 7 7 7 7 7 7 
7 7 7 7 7 7 7 7 423 424 424 424 424 424 424 424 424 424 424 424 424 424 424 424 424 424 424 424 424 424 424 424 424 424 424 424 424 424 424 424 424 425 7 7 7 7 7 7 7 7 
7 7 7 7 7 7 7 7 423 424 424 424 424 424 424 424 424 424 424 424 424 424 424 424 424 424 424 424 424 424 424 424 424 424 424 424 424 424 424 424 424 425 7 7 7 7 7 7 7 7 
7 7 7 7 7 7 7 7 423 424 424 424 424 424 424 424 424 424 424 424 424 424 424 424 424 424 424 424 424 424 424 424 424 424 424 424 424 424 424 424 424 425 7 7 7 7 7 7 7 7 
7 7 7 7 7 7 7 7 423 424 424 424 424 424 424 424 424 424 424 424 424 424 424 424 424 424 424 424 424 424 424 424 424 424 424 424 424 424 424 424 424 425 7 7 7 7 7 7 7 7 
7 7 7 7 7 7 7 7 423 424 424 424 424 424 424 424 424 424 424 424 424 424 424 424 424 424 424 424 424 424 424 424 424 424 424 424 424 424 424 424 424 425 7 7 7 7 7 7 7 7 
7 7 7 7 7 7 7 7 423 424 424 424 424 424 424 424 424 424 424 424 424 424 424 424 424 424 424 424 424 424 424 424 424 424 424 424 424 424 424 424 424 425 7 7 7 7 7 7 7 7 
7 7 7 7 7 7 7 7 423 424 424 424 424 424 424 424 424 424 424 424 424 424 424 424 424 424 424 424 424 424 424 424 424 424 424 424 424 424 424 424 424 425 7 7 7 7 7 7 7 7 
7 7 7 7 7 7 7 7 423 424 424 424 424 424 424 424 424 424 424 424 424 424 424 424 424 424 424 424 424 424 424 424 424 424 424 424 424 424 424 424 424 425 7 7 7 7 7 7 7 7 
7 7 7 7 7 7 7 7 423 424 424 424 424 424 424 424 424 424 424 424 424 424 424 424 424 424 424 424 424 424 424 424 424 424 424 424 424 424 424 424 424 425 7 7 7 7 7 7 7 7 
7 7 7 7 7 7 7 7 423 424 424 424 424 424 424 424 424 424 424 424 424 424 424 424 424 424 424 424 424 424 424 424 424 424 424 424 424 424 424 424 424 425 7 7 7 7 7 7 7 7 
7 7 7 7 7 7 7 7 423 424 424 424 424 424 424 424 424 424 424 424 424 424 424 424 424 424 424 424 424 424 424 424 424 424 424 424 424 424 424 424 424 425 7 7 7 7 7 7 7 7 
7 7 7 7 7 7 7 7 423 424 424 424 424 424 424 424 424 424 424 424 424 424 424 424 424 424 424 424 424 424 424 424 424 424 424 424 424 424 424 424 424 425 7 7 7 7 7 7 7 7 
7 7 7 7 7 7 7 7 423 424 424 424 424 424 424 424 424 424 424 424 424 424 424 424 424 424 424 424 424 424 424 424 424 424 424 424 424 424 424 424 424 425 7 7 7 7 7 7 7 7 
7 7 7 7 7 7 7 7 423 424 424 424 424 424 424 424 424 424 424 424 424 424 424 424 424 424 424 424 424 424 424 424 424 424 424 424 424 424 424 424 424 425 7 7 7 7 7 7 7 7 
7 7 7 7 7 7 7 7 423 424 424 424 424 424 424 424 424 424 424 424 424 424 424 424 424 424 424 424 424 424 424 424 424 424 424 424 424 424 424 424 424 425 7 7 7 7 7 7 7 7 
7 7 7 7 7 7 7 7 423 424 424 424 424 424 424 424 424 424 424 424 424 424 424 424 424 424 424 424 424 424 424 424 424 424 424 424 424 424 424 424 424 425 7 7 7 7 7 7 7 7 
7 7 7 7 7 7 7 7 423 424 424 424 424 424 424 424 424 424 424 424 424 424 424 424 424 424 424 424 424 424 424 424 424 424 424 424 424 424 424 424 424 425 7 7 7 7 7 7 7 7 
7 7 7 7 7 7 7 7 423 424 424 424 424 424 424 424 424 424 424 424 424 424 424 424 424 424 424 424 424 424 424 424 424 424 424 424 424 424 424 424 424 425 7 7 7 7 7 7 7 7 
7 7 7 7 7 7 7 7 423 424 424 424 424 424 424 424 424 424 424 424 424 424 424 424 424 424 424 424 424 424 424 424 424 424 424 424 424 424 424 424 424 425 7 7 7 7 7 7 7 7 
7 7 7 7 7 7 7 7 423 424 424 424 424 424 424 424 424 424 424 424 424 424 424 424 424 424 424 424 424 424 424 424 424 424 424 424 424 424 424 424 424 425 7 7 7 7 7 7 7 7 
7 7 7 7 7 7 7 7 423 424 424 424 424 424 424 424 424 424 424 424 424 424 424 424 424 424 424 424 424 424 424 424 424 424 424 424 424 424 424 424 424 425 7 7 7 7 7 7 7 7 
7 7 7 7 7 7 7 7 423 424 424 424 424 424 424 424 424 424 424 424 424 424 424 424 424 424 424 424 424 424 424 424 424 424 424 424 424 424 424 424 424 425 7 7 7 7 7 7 7 7 
7 7 7 7 7 7 7 7 423 424 424 424 424 424 424 424 424 424 424 424 424 424 424 424 424 424 424 424 424 424 424 424 424 424 424 424 424 424 424 424 424 425 7 7 7 7 7 7 7 7 
7 7 7 7 7 7 7 7 423 424 424 424 424 424 424 424 424 424 424 424 424 424 424 424 424 424 424 424 424 424 424 424 424 424 424 424 424 424 424 424 424 425 7 7 7 7 7 7 7 7 
7 7 7 7 7 7 7 7 423 424 424 424 424 424 424 424 424 424 424 424 424 424 424 424 424 424 424 424 424 424 424 424 424 424 424 424 424 424 424 424 424 425 7 7 7 7 7 7 7 7 
7 7 7 7 7 7 7 7 423 424 424 424 424 424 424 424 424 424 424 424 424 424 424 424 424 424 424 424 424 424 424 424 424 424 424 424 424 424 424 424 424 425 7 7 7 7 7 7 7 7 
7 7 7 7 7 7 7 7 423 424 424 424 424 424 424 424 424 424 424 424 424 424 424 424 424 424 424 424 424 424 424 424 424 424 424 424 424 424 424 424 424 425 7 7 7 7 7 7 7 7 
7 7 7 7 7 7 7 7 423 424 424 424 424 424 424 424 424 424 424 424 424 424 424 424 424 424 424 424 424 424 424 424 424 424 424 424 424 424 424 424 424 425 7 7 7 7 7 7 7 7 
7 7 7 7 7 7 7 7 423 424 424 424 424 424 424 424 424 424 424 424 424 424 424 424 424 424 424 424 424 424 424 424 424 424 424 424 424 424 424 424 424 425 7 7 7 7 7 7 7 7 
7 7 7 7 7 7 7 7 423 424 424 424 424 424 424 424 424 424 424 424 424 424 424 424 424 424 424 424 424 309 309 309 424 424 424 424 424 424 424 424 424 425 7 7 7 7 7 7 7 7 
7 7 7 7 7 7 7 7 551 568 568 568 568 568 568 568 568 676 676 676 676 676 676 676 676 695 676 279 280 281 283 282 284 568 676 695 693 676 676 676 676 677 7 7 7 7 7 7 7 7 
7 7 7 7 7 7 7 7 675 652 676 676 676 676 676 676 676 676 676 676 676 676 676 676 676 676 676 321 322 323 324 325 326 693 676 676 676 676 507 509 676 677 7 7 7 7 7 7 7 7 
7 7 7 7 7 7 7 7 675 651 651 653 651 693 693 693 693 693 693 652 507 718 718 508 509 652 652 363 364 365 366 367 368 652 652 652 507 718 719 675 653 549 7 7 7 7 7 7 7 7 
7 7 7 7 7 7 7 7 675 693 693 653 653 651 693 693 693 693 652 507 719 129 130 131 551 568 568 405 406 407 408 409 410 568 568 652 549 7 7 717 718 719 7 7 7 7 7 7 7 7 
7 7 7 7 7 7 7 7 717 718 718 718 718 718 718 718 718 718 718 719 7 171 172 173 551 568 568 568 568 568 568 568 568 568 652 652 549 7 7 7 7 7 7 7 7 7 7 7 7 7 
7 7 7 7 7 7 7 7 7 7 7 7 7 7 7 7 7 7 7 7 7 213 214 215 717 509 652 652 652 652 652 652 652 652 652 507 719 7 7 7 7 7 7 7 7 7 7 7 7 7 
7 7 7 7 7 7 7 7 7 7 7 7 7 7 7 7 7 7 7 7 7 7 7 7 7 717 508 508 508 508 718 718 718 718 718 719 7 7 7 7 7 7 7 7 7 7 7 7 7 7 
7 7 7 7 7 7 7 7 7 7 7 7 7 7 7 7 7 7 7 7 7 7 7 7 7 7 7 7 7 7 7 7 7 7 7 7 7 7 7 7 7 7 7 7 7 7 7 7 7 7 
7 7 7 7 7 7 7 7 7 7 7 7 7 7 7 7 7 7 7 7 7 7 7 7 7 7 7 7 7 7 7 7 7 7 7 7 7 7 7 7 7 7 7 7 7 7 7 7 7 7 
