51 36 36 36 36 36 36 36 36 36 36 36 120 142 142 142 142 142 142 142 142 142 142 142 142 142 142 142 142 142 142 142 142 142 142 142 142 142 142 142 0 0 0 0 0 0 0 0 0 0 
67 195 195 195 195 195 195 195 195 195 195 195 146 142 142 142 142 142 142 142 142 142 142 142 142 142 142 142 142 142 142 142 142 142 142 142 142 142 142 142 0 0 0 0 0 0 0 0 0 0 
67 195 195 195 195 195 195 195 195 195 195 195 146 142 142 142 142 142 142 142 142 142 142 142 142 142 142 142 142 142 142 142 142 142 142 142 142 142 142 142 0 0 0 0 0 0 0 0 0 0 
67 195 195 195 195 195 195 224 224 224 224 195 110 112 112 112 112 112 111 111 111 111 111 111 111 120 142 142 142 142 142 142 142 142 142 142 142 142 142 142 0 0 0 0 0 0 0 0 0 0 
67 1 1 1 1 1 1 1 1 1 1 1 133 133 133 133 133 133 134 134 134 134 134 107 107 114 142 142 142 142 142 142 142 142 142 142 142 142 142 142 0 0 0 0 0 0 0 0 0 0 
67 1 1 1 1 1 1 1 1 1 1 1 133 133 133 133 133 133 134 134 134 134 134 134 134 114 142 142 142 142 142 142 142 142 142 142 142 142 142 142 0 0 0 0 0 0 0 0 0 0 
67 1 1 1 1 1 1 1 1 1 1 1 133 133 133 133 133 133 134 134 134 134 134 134 134 114 142 142 142 142 142 142 142 142 142 142 142 142 142 142 0 0 0 0 0 0 0 0 0 0 
67 1 1 1 1 1 1 1 1 1 1 1 1 1 1 1 1 1 1 1 0 0 0 0 0 78 142 142 142 142 142 142 142 142 142 142 142 142 142 142 0 0 0 0 0 0 0 0 0 0 
67 1 1 1 1 1 1 1 1 1 1 1 1 1 1 1 1 1 1 1 0 0 0 0 0 78 142 142 142 142 142 142 142 142 142 142 142 142 142 142 0 0 0 0 0 0 0 0 0 0 
85 16 16 16 16 16 16 16 16 16 16 17 1 1 1 1 1 1 1 1 0 0 0 0 0 78 142 142 142 142 142 142 142 142 142 142 142 142 142 142 0 0 0 0 0 0 0 0 0 0 
142 142 142 142 142 142 142 142 142 142 142 147 1 1 1 1 1 1 1 1 0 0 0 0 0 78 142 142 142 142 142 142 142 142 142 142 142 142 142 142 0 0 0 0 0 0 0 0 0 0 
142 142 142 142 142 142 142 142 142 142 142 147 1 1 1 1 1 1 1 1 0 0 0 0 0 78 142 142 142 142 142 142 142 142 142 142 142 142 142 142 0 0 0 0 0 0 0 0 0 0 
142 142 142 142 142 142 142 142 142 142 142 147 1 1 1 1 1 0 1 1 0 0 0 0 0 52 142 142 142 142 142 142 142 142 142 142 142 142 142 142 0 0 0 0 0 0 0 0 0 0 
51 36 36 36 36 36 36 36 36 36 36 113 1 1 1 1 0 0 0 0 0 0 0 0 0 52 142 142 142 142 142 142 142 142 142 142 142 142 142 142 0 0 0 0 0 0 0 0 0 0 
53 267 267 267 267 267 267 267 267 267 267 271 1 1 1 1 0 0 0 0 0 0 0 0 0 52 142 142 142 142 142 142 142 142 142 142 142 142 142 142 0 0 0 0 0 0 0 0 0 0 
53 340 341 340 341 267 267 267 267 267 267 271 1 1 1 1 0 0 0 0 0 0 0 0 0 52 142 142 142 142 142 142 142 142 142 142 142 142 142 142 0 0 0 0 0 0 0 0 0 0 
53 360 361 340 341 267 267 267 267 267 267 271 1 1 1 1 0 0 0 0 0 0 0 0 0 52 51 36 36 36 36 36 36 36 36 36 44 54 142 142 0 0 0 0 0 0 0 0 0 0 
53 406 407 404 405 1 1 1 1 1 1 1 1 1 1 1 0 0 0 0 0 0 0 0 0 52 53 102 102 102 340 341 343 102 102 102 114 142 142 142 0 0 0 0 0 0 0 0 0 0 
53 1 1 1 1 1 1 1 1 1 1 1 1 1 1 1 0 0 0 0 0 0 0 0 0 52 53 102 102 102 340 341 343 102 102 102 114 142 142 142 0 0 0 0 0 0 0 0 0 0 
53 1 1 1 1 1 1 1 1 1 1 1 1 1 1 1 0 0 0 0 0 1 1 1 1 178 179 422 423 102 360 361 363 102 422 423 114 142 142 142 0 0 0 0 0 0 0 0 0 0 
53 1 1 1 1 1 1 1 1 1 1 1 1 1 1 1 0 0 0 0 0 1 1 1 1 134 134 128 128 128 128 128 128 128 128 129 76 142 142 142 0 0 0 0 0 0 0 0 0 0 
53 1 1 1 1 1 1 1 1 1 1 1 1 1 1 1 0 0 0 0 0 0 1 1 1 134 134 128 128 128 128 128 128 128 128 128 76 142 142 142 0 0 0 0 0 0 0 0 0 0 
53 1 1 1 1 1 1 1 1 1 1 1 1 1 1 1 0 0 0 0 0 0 0 0 1 134 134 128 128 128 128 128 128 128 128 128 76 142 142 142 0 0 0 0 0 0 0 0 0 0 
53 1 1 1 1 1 1 1 1 1 1 1 1 1 1 1 0 0 0 0 0 0 0 0 0 0 0 128 128 128 128 128 128 128 128 128 76 142 142 142 0 0 0 0 0 0 0 0 0 0 
53 1 1 1 1 1 1 1 1 1 1 1 1 1 1 1 0 0 0 0 0 0 0 0 0 0 0 128 128 128 128 128 128 128 128 128 76 142 142 142 0 0 0 0 0 0 0 0 0 0 
85 6 6 6 6 6 6 6 6 7 7 7 7 7 7 17 1 14 15 15 15 15 15 15 15 15 15 15 15 15 15 15 15 15 15 15 84 142 142 142 0 0 0 0 0 0 0 0 0 0 
142 142 142 142 142 142 142 142 142 142 142 142 142 142 142 85 15 84 142 142 142 142 142 142 142 142 142 142 142 142 142 142 142 142 142 142 142 142 142 142 0 0 0 0 0 0 0 0 0 0 
142 142 142 142 142 142 142 142 142 142 142 142 142 142 142 142 142 142 142 142 142 142 142 142 142 142 142 142 142 142 142 142 142 142 142 142 142 142 142 142 0 0 0 0 0 0 0 0 0 0 
142 142 142 142 142 142 142 142 142 142 142 142 142 142 142 142 142 142 142 142 142 142 142 142 142 142 142 142 142 142 142 142 142 142 142 142 142 142 142 142 0 0 0 0 0 0 0 0 0 0 
142 142 142 142 142 142 142 142 142 142 142 142 142 142 142 142 142 142 142 142 142 142 142 142 142 142 142 142 142 142 142 142 142 142 142 142 142 142 142 142 0 0 0 0 0 0 0 0 0 0 
142 142 142 142 142 142 142 142 142 142 142 142 142 142 142 142 142 142 142 142 142 142 142 142 142 142 142 142 142 142 142 142 142 142 142 142 142 142 142 142 0 0 0 0 0 0 0 0 0 0 
142 142 142 142 142 142 142 142 142 142 142 142 142 142 142 142 142 142 142 142 142 142 142 142 142 142 142 142 142 142 142 142 142 142 142 142 142 142 142 142 0 0 0 0 0 0 0 0 0 0 
142 142 142 142 142 142 142 142 142 142 142 142 142 142 142 142 142 142 142 142 142 142 142 142 142 142 142 142 142 142 142 142 142 142 142 142 142 142 142 142 0 0 0 0 0 0 0 0 0 0 
142 142 142 142 142 142 142 142 142 142 142 142 142 142 142 142 142 142 142 142 142 142 142 142 142 142 142 142 142 142 142 142 142 142 142 142 142 142 142 142 0 0 0 0 0 0 0 0 0 0 
142 142 142 142 142 142 142 142 142 142 142 142 142 142 142 142 142 142 142 142 142 142 142 142 142 142 142 142 142 142 142 142 142 142 142 142 142 142 142 142 0 0 0 0 0 0 0 0 0 0 
142 142 142 142 142 142 142 142 142 142 142 142 142 142 142 142 142 142 142 142 142 142 142 142 142 142 142 142 142 142 142 142 142 142 142 142 142 142 142 142 0 0 0 0 0 0 0 0 0 0 
142 142 142 142 142 142 142 142 142 142 142 142 142 142 142 142 142 142 142 142 142 142 142 142 142 142 142 142 142 142 142 142 142 142 142 142 142 142 142 142 0 0 0 0 0 0 0 0 0 0 
142 142 142 142 142 142 142 142 142 142 142 142 142 142 142 142 142 142 142 142 142 142 142 142 142 142 142 142 142 142 142 142 142 142 142 142 142 142 142 142 0 0 0 0 0 0 0 0 0 0 
142 142 142 142 142 142 142 142 142 142 142 142 142 142 142 142 142 142 142 142 142 142 142 142 142 142 142 142 142 142 142 142 142 142 142 142 142 142 142 142 0 0 0 0 0 0 0 0 0 0 
142 142 142 142 142 142 142 142 142 142 142 142 142 142 142 142 142 142 142 142 142 142 142 142 142 142 142 142 142 142 142 142 142 142 142 142 142 142 142 142 0 0 0 0 0 0 0 0 0 0 
0 0 0 0 0 0 0 0 0 0 0 0 0 0 0 0 0 0 0 0 0 0 0 0 0 0 0 0 0 0 0 0 0 0 0 0 0 0 0 0 0 0 0 0 0 0 0 0 0 0 
0 0 0 0 0 0 0 0 0 0 0 0 0 0 0 0 0 0 0 0 0 0 0 0 0 0 0 0 0 0 0 0 0 0 0 0 0 0 0 0 0 0 0 0 0 0 0 0 0 0 
0 0 0 0 0 0 0 0 0 0 0 0 0 0 0 0 0 0 0 0 0 0 0 0 0 0 0 0 0 0 0 0 0 0 0 0 0 0 0 0 0 0 0 0 0 0 0 0 0 0 
0 0 0 0 0 0 0 0 0 0 0 0 0 0 0 0 0 0 0 0 0 0 0 0 0 0 0 0 0 0 0 0 0 0 0 0 0 0 0 0 0 0 0 0 0 0 0 0 0 0 
0 0 0 0 0 0 0 0 0 0 0 0 0 0 0 0 0 0 0 0 0 0 0 0 0 0 0 0 0 0 0 0 0 0 0 0 0 0 0 0 0 0 0 0 0 0 0 0 0 0 
0 0 0 0 0 0 0 0 0 0 0 0 0 0 0 0 0 0 0 0 0 0 0 0 0 0 0 0 0 0 0 0 0 0 0 0 0 0 0 0 0 0 0 0 0 0 0 0 0 0 
0 0 0 0 0 0 0 0 0 0 0 0 0 0 0 0 0 0 0 0 0 0 0 0 0 0 0 0 0 0 0 0 0 0 0 0 0 0 0 0 0 0 0 0 0 0 0 0 0 0 
0 0 0 0 0 0 0 0 0 0 0 0 0 0 0 0 0 0 0 0 0 0 0 0 0 0 0 0 0 0 0 0 0 0 0 0 0 0 0 0 0 0 0 0 0 0 0 0 0 0 
0 0 0 0 0 0 0 0 0 0 0 0 0 0 0 0 0 0 0 0 0 0 0 0 0 0 0 0 0 0 0 0 0 0 0 0 0 0 0 0 0 0 0 0 0 0 0 0 0 0 
0 0 0 0 0 0 0 0 0 0 0 0 0 0 0 0 0 0 0 0 0 0 0 0 0 0 0 0 0 0 0 0 0 0 0 0 0 0 0 0 0 0 0 0 0 0 0 0 0 0 
