51 111 111 111 111 111 111 111 111 120 2
115 132 132 132 132 132 132 132 132 114 2
53 100 100 100 360 361 100 100 100 108 2
53 100 422 423 340 341 454 455 100 108 2
53 32 32 32 32 32 32 32 32 108 2
53 0 0 0 0 0 0 0 0 108 2
53 0 0 0 0 0 0 0 0 108 2
53 0 0 0 0 0 0 0 0 108 2
53 0 0 0 0 0 0 0 0 108 2
131 151 151 17 0 0 14 151 151 84 2
2 2 2 131 150 150 140 2 2 2 2