51 111 111 111 111 111 111 111 111 120
115 132 132 132 132 132 132 132 132 114
53 100 100 100 360 361 100 100 100 108 
53 100 422 423 340 341 454 455 100 108
53 32 32 32 32 32 32 32 32 108
53 0 0 0 0 0 0 0 0 108
53 0 0 0 0 0 0 0 0 108
53 0 0 0 0 0 0 0 0 108
53 0 0 0 0 0 0 0 0 108 
131 151 151 151 151 151 151 151 151 84
