51 111 111 111 111 111 111 111 111 111 111 50
53 101 101 101 101 680 681 101 101 101 101 52
53 101 101 340 341 680 681 342 343 101 101 52
53 335 336 360 361 680 681 374 375 396 397 52
53 0 0 0 0 0 0 0 0 0 0 52
53 0 0 886 887 0 0 0 0 0 0 52
53 0 0 128 129 0 0 0 0 0 0 52
53 0 0 0 0 0 0 0 0 0 0 52
53 61 61 61 61 61 61 61 61 61 61 52
53 61 61 61 61 61 61 61 61 61 61 52
85 87 87 87 17 61 61 14 6 6 87 84
2 2 2 2 85 7 7 84 25 25 2 2