132 132 132 132 132 216 217 217 217 133 217 217 217 675 694 651 651 693 693 693 693 687 646 648 309 309 309 325 325 325 325 325 316 316 309 309 309 255 466 467 301 301 301 301 381 341 309 316 316 316 
132 132 216 216 216 216 217 217 133 390 217 217 217 675 694 651 694 694 693 693 693 687 646 648 309 309 309 309 325 325 325 325 316 316 316 309 309 425 217 217 217 217 301 217 423 309 309 316 316 316 
216 132 216 217 217 217 217 133 133 133 217 217 633 593 693 651 694 693 693 693 693 687 646 648 648 309 309 309 309 309 325 316 316 316 316 309 309 425 217 217 217 301 301 217 423 310 309 316 316 316 
132 216 216 217 217 217 217 217 217 217 633 634 593 694 693 651 651 695 693 687 687 687 687 648 309 309 309 309 309 316 316 316 316 316 316 309 309 425 217 217 217 301 217 381 341 310 309 309 316 316 
216 216 217 217 217 217 217 390 133 217 675 651 694 694 693 693 695 693 693 687 687 687 648 648 309 309 309 309 309 316 316 571 571 571 571 309 309 339 340 383 217 301 217 423 310 310 309 309 310 316 
378 340 340 340 383 133 133 217 133 217 675 694 694 694 694 695 695 694 693 693 693 687 648 309 309 325 325 309 309 309 316 571 571 571 571 309 309 267 267 297 217 301 301 423 309 309 309 309 309 309 
296 267 267 267 297 133 390 390 133 217 675 694 694 694 694 695 693 695 673 673 693 687 309 309 309 325 325 309 309 309 309 571 571 571 571 309 309 267 255 467 217 217 217 423 309 309 309 309 309 309 
296 267 267 267 294 217 133 217 633 592 593 694 694 694 694 695 693 695 673 693 693 648 309 309 309 309 325 316 316 316 309 571 571 571 571 309 309 267 297 217 217 385 217 465 257 309 309 309 309 309 
462 254 267 267 297 217 133 217 675 694 694 694 694 694 695 693 694 693 687 646 646 648 648 309 309 309 325 316 316 309 309 309 309 309 309 309 309 309 297 217 217 385 385 431 423 309 309 309 309 309 
217 462 253 253 467 217 390 217 675 694 694 694 694 695 695 693 694 695 694 646 646 687 648 309 309 309 309 309 309 309 309 309 309 309 309 309 309 309 339 383 217 217 431 431 465 257 309 309 309 316 
217 217 217 217 217 217 217 675 694 676 676 694 694 695 693 693 693 695 695 694 646 646 648 309 309 309 309 309 309 309 309 309 309 316 316 309 309 309 309 425 431 431 217 217 217 423 309 309 309 903 
217 217 133 217 175 217 217 717 718 718 506 676 695 695 694 568 651 653 653 673 646 687 648 648 309 309 309 309 325 309 309 316 309 316 316 309 951 952 742 742 742 742 742 742 742 742 953 954 903 903 
217 217 133 49 175 217 431 431 431 431 675 676 694 695 695 568 651 651 651 646 646 687 648 309 309 309 325 325 325 325 325 316 316 316 316 316 909 910 784 784 784 784 784 784 784 784 911 912 903 903 
216 132 216 217 175 217 431 431 431 431 675 676 694 694 695 568 568 568 568 673 645 687 648 648 309 309 309 325 325 325 309 309 309 309 309 309 309 309 309 425 217 385 431 217 423 309 309 309 309 309 
132 132 132 49 431 431 431 634 634 592 593 676 676 694 652 652 568 568 568 694 645 645 647 648 309 309 309 309 309 309 309 309 309 316 316 309 252 256 256 467 431 431 217 217 423 309 571 571 571 571 
216 132 132 217 431 431 593 676 676 676 673 694 693 693 694 652 694 694 645 645 645 647 648 309 309 309 323 309 309 309 309 309 309 316 309 309 425 301 217 431 301 431 217 381 341 309 571 571 571 571 
132 132 216 431 217 551 694 673 673 652 694 693 693 693 694 694 694 694 645 645 687 687 648 309 309 309 323 323 323 316 309 316 316 316 316 309 425 301 301 301 301 301 217 423 309 309 571 571 571 571 
216 216 217 431 431 551 673 673 694 652 652 695 693 694 694 694 694 694 693 645 687 648 648 648 309 309 309 323 316 316 309 309 325 325 316 309 339 340 383 217 385 385 217 465 257 309 571 571 571 571 
216 49 49 217 217 551 673 673 694 694 695 693 693 694 694 694 694 693 694 645 645 648 648 648 309 309 311 309 316 309 309 309 325 325 325 309 325 309 425 217 385 385 217 217 423 309 309 309 316 316 
217 217 217 217 217 717 509 694 694 694 694 651 695 693 694 693 693 694 694 694 687 687 648 648 309 309 311 311 311 309 309 309 309 309 309 309 325 309 425 217 217 217 217 217 423 309 309 309 309 316 
217 217 217 217 217 217 717 509 694 694 694 651 693 693 693 694 693 693 694 694 646 687 687 690 690 690 648 309 309 309 309 309 309 309 310 309 309 309 425 217 217 217 217 217 423 309 309 309 309 309 
216 298 175 175 217 217 217 551 694 694 694 693 693 694 694 694 693 693 694 694 646 646 687 687 645 645 648 309 309 309 316 309 309 309 309 309 309 309 339 383 217 217 431 217 465 257 309 309 309 309 
216 298 298 175 217 217 633 593 694 694 694 693 693 695 694 694 694 694 694 694 694 646 646 687 645 645 648 309 309 309 316 316 309 309 309 309 309 309 309 425 217 217 431 431 217 465 256 256 254 309 
298 175 298 217 633 592 593 694 694 694 651 651 651 694 695 694 694 694 694 694 694 687 646 646 648 690 648 309 309 316 311 316 316 309 309 309 309 309 309 339 382 382 383 217 385 301 301 301 465 253 
175 175 217 633 593 673 694 694 694 651 694 651 693 651 695 695 694 694 694 694 694 687 646 687 648 648 309 309 309 325 325 316 316 316 309 309 309 309 309 309 309 324 425 217 301 217 301 301 217 217 
217 217 217 551 694 694 694 694 693 693 693 693 693 694 694 695 694 694 673 673 689 687 647 647 648 648 309 309 325 325 325 316 316 316 309 309 309 309 309 309 309 309 425 217 431 133 133 385 385 133 
217 217 217 551 694 694 694 693 693 693 693 693 693 694 694 694 694 673 673 689 689 645 645 648 648 309 309 325 325 316 316 316 316 316 309 309 325 325 309 309 309 309 425 217 431 431 431 133 133 217 
217 217 217 551 694 694 651 693 651 693 693 693 693 693 694 694 673 673 689 689 689 646 645 648 648 309 309 309 309 325 316 309 309 309 325 325 325 309 309 309 309 309 425 217 217 217 217 133 381 340 
591 592 592 593 651 651 693 693 693 693 693 693 694 694 693 673 689 689 689 689 689 646 689 690 648 309 309 309 309 309 309 309 309 309 309 316 316 316 309 309 309 309 339 340 340 340 340 340 341 309 
694 651 651 651 651 693 693 693 693 693 693 693 694 694 673 673 689 687 646 689 689 689 689 690 309 309 309 309 309 309 309 309 325 325 316 316 316 316 316 309 309 309 309 309 309 309 309 309 309 309 
693 693 693 693 693 693 693 687 687 693 687 687 687 689 673 687 687 689 689 689 647 690 690 690 309 309 309 309 309 309 309 309 316 316 316 316 316 316 316 309 309 309 309 309 309 309 309 309 309 309 
693 693 693 693 687 687 687 687 646 646 646 646 689 689 689 647 689 690 690 690 690 690 690 309 309 309 325 325 309 316 311 309 309 316 316 316 316 309 309 309 309 309 309 309 309 309 309 309 309 309 
687 687 687 687 687 687 687 690 690 690 690 690 647 690 690 690 690 690 690 690 690 690 690 309 309 309 325 325 316 316 311 309 309 309 309 309 309 309 309 309 309 309 309 309 309 309 309 309 309 309 
687 687 690 690 690 690 690 690 690 690 690 690 690 690 309 309 309 309 309 309 309 309 309 309 309 309 309 309 316 316 316 316 311 309 309 309 309 309 309 309 309 309 309 309 309 309 309 309 309 309 
690 690 690 690 690 309 309 309 309 309 309 309 309 309 309 309 309 309 309 309 309 309 309 309 309 309 309 311 316 309 312 312 309 309 309 309 309 309 309 309 309 309 309 309 309 309 309 309 309 309 
309 309 309 309 309 309 309 309 309 309 309 309 309 309 309 309 309 309 309 309 309 309 309 309 309 309 309 309 311 312 309 309 309 309 309 309 309 309 309 309 309 309 309 309 309 309 309 319 319 309 
309 309 309 309 309 309 309 309 309 309 309 309 309 309 309 309 309 309 309 309 309 309 309 309 309 309 309 309 309 309 309 309 309 309 309 309 309 309 309 309 309 309 319 319 309 309 319 319 319 319 
309 309 309 309 309 309 309 309 309 309 309 309 309 309 309 309 309 309 309 309 309 309 309 309 309 309 309 309 309 309 309 309 309 309 309 309 309 309 309 309 309 319 319 319 319 319 319 319 319 319 
309 309 309 309 309 309 309 309 309 309 309 309 309 309 309 309 309 309 309 309 309 309 309 309 309 309 309 309 309 309 309 309 312 309 309 309 309 309 309 309 309 319 319 319 319 319 237 218 218 218 
309 309 309 309 309 309 309 309 309 309 309 309 309 309 309 309 309 309 309 309 309 309 309 309 309 309 309 309 309 309 309 309 309 309 309 309 309 309 309 319 319 319 319 319 237 218 218 218 218 218 
309 309 309 309 309 309 309 309 309 744 309 309 309 309 744 309 309 309 309 742 742 742 742 742 742 309 309 309 309 309 309 309 309 309 309 309 309 309 309 319 237 237 237 237 759 970 970 970 970 971 
309 309 309 309 309 309 309 309 309 743 309 309 309 309 743 309 309 309 309 742 309 309 309 309 309 309 309 309 309 309 309 309 309 309 309 309 309 309 309 319 237 237 759 760 971 217 217 217 217 217 
309 309 309 309 309 309 309 309 309 743 309 309 309 571 742 309 309 309 309 742 309 309 309 309 309 309 309 309 309 309 309 309 309 309 309 309 309 309 319 237 237 237 929 217 217 217 217 217 431 217 
571 571 571 571 571 571 571 571 571 742 571 571 571 571 742 571 571 571 571 742 309 309 309 309 309 309 309 309 309 309 309 309 309 309 309 309 319 319 319 237 759 970 971 217 431 217 431 431 431 217 
571 309 571 571 571 571 571 571 571 742 571 309 571 571 742 571 571 571 571 742 309 309 309 309 309 309 309 309 309 309 309 309 309 309 319 319 319 319 319 237 929 217 217 431 431 550 217 217 217 217 
743 743 743 743 743 743 743 743 743 743 743 743 743 743 743 743 743 743 743 741 309 309 309 309 309 309 309 309 309 309 309 309 309 309 319 319 237 759 760 760 971 550 431 431 217 217 217 217 217 217 
742 742 742 742 742 742 742 742 742 741 742 742 742 742 742 742 742 742 742 741 309 309 309 309 309 309 309 309 309 309 309 309 309 319 319 456 759 971 550 217 217 217 217 217 766 767 767 768 217 217 
742 953 954 784 784 784 784 784 784 784 784 784 913 913 913 913 913 913 913 741 309 309 309 309 309 309 309 309 309 309 309 309 309 319 319 237 929 550 217 431 431 217 217 217 808 809 809 768 217 217 
742 911 912 742 742 742 742 742 742 742 742 742 742 742 742 742 742 742 742 741 309 309 309 309 309 309 309 309 309 309 309 309 319 319 319 237 929 217 431 431 431 431 431 850 808 809 809 810 217 217 
742 742 742 742 742 742 742 742 742 742 742 742 742 742 742 742 742 742 742 741 309 309 309 309 309 309 309 309 309 309 309 319 319 237 237 237 929 217 431 431 431 431 217 217 850 851 851 852 217 217 
